2 2 2 2 2 2 2 2 2 2 2 2 2 2 2 2 2 2 2 2 2 2 2 2 2 2 2 2 
2 0 0 0 0 0 0 0 0 0 0 0 0 2 2 0 0 0 0 0 0 0 0 0 0 0 0 2 
2 1 2 2 2 2 0 2 2 2 2 2 0 2 2 0 2 2 2 2 2 0 2 2 2 2 1 2 
2 0 2 8 8 2 0 2 8 8 8 2 0 2 2 0 2 8 8 8 2 0 2 8 8 2 0 2 
2 0 2 2 2 2 0 2 2 2 2 2 0 2 2 0 2 2 2 2 2 0 2 2 2 2 0 2 
2 0 0 0 0 0 0 0 0 0 0 0 0 0 0 0 0 0 0 0 0 0 0 0 0 0 0 2 
2 0 2 2 2 2 0 2 2 0 2 2 2 2 2 2 2 2 0 2 2 0 2 2 2 2 0 2 
2 0 2 2 2 2 0 2 2 0 2 2 2 2 2 2 2 2 0 2 2 0 2 2 2 2 0 2 
2 0 0 0 0 0 0 2 2 0 0 0 0 2 2 0 0 0 0 2 2 0 0 0 0 0 0 2 
2 2 2 2 2 2 0 2 2 2 2 2 8 2 2 8 2 2 2 2 2 0 2 2 2 2 2 2 
8 8 8 8 8 2 0 2 2 2 2 2 8 2 2 8 2 2 2 2 2 0 2 8 8 8 8 8 
8 8 8 8 8 2 0 2 2 8 8 8 8 8 8 8 8 8 8 2 2 0 2 8 8 8 8 8 
8 8 8 8 8 2 0 2 2 8 8 8 8 8 8 8 8 8 8 2 2 0 2 8 8 8 8 8 
2 2 2 2 2 2 0 2 2 8 8 2 2 8 8 2 2 8 8 2 2 0 2 2 2 2 2 2 
8 8 8 8 8 8 0 8 8 8 8 2 8 8 8 8 2 8 8 8 8 0 8 8 8 8 8 8 
8 8 8 8 8 8 0 8 8 8 8 2 8 8 8 8 2 8 8 8 8 0 8 8 8 8 8 8 
8 8 8 8 8 8 0 8 8 8 8 2 8 8 8 8 2 8 8 8 8 0 8 8 8 8 8 8 
2 2 2 2 2 2 0 2 2 8 8 2 2 2 2 2 2 8 8 2 2 0 2 2 2 2 2 2 
8 8 8 8 8 2 0 2 2 8 8 8 8 8 8 8 8 8 8 2 2 0 2 8 8 8 8 8 
8 8 8 8 8 2 0 2 2 8 8 8 8 8 8 8 8 8 8 2 2 0 2 8 8 8 8 8 
8 8 8 8 8 2 0 2 2 8 2 2 2 2 2 2 2 2 8 2 2 0 2 8 8 8 8 8 
2 2 2 2 2 2 0 2 2 8 2 2 2 2 2 2 2 2 8 2 2 0 2 2 2 2 2 2 
2 0 0 0 0 0 0 0 0 0 0 0 0 2 2 0 0 0 0 0 0 0 0 0 0 0 0 2 
2 0 2 2 2 2 0 2 2 2 2 2 0 2 2 0 2 2 2 2 2 0 2 2 2 2 0 2 
2 0 2 2 2 2 0 2 2 2 2 2 0 2 2 0 2 2 2 2 2 0 2 2 2 2 0 2 
2 0 0 0 2 2 0 0 0 0 0 0 0 0 0 0 0 0 0 0 0 0 2 2 0 0 0 2 
2 2 2 0 2 2 0 2 2 0 2 2 2 2 2 2 2 2 0 2 2 0 2 2 0 2 2 2 
2 2 2 0 2 2 0 2 2 0 2 2 2 2 2 2 2 2 0 2 2 0 2 2 0 2 2 2 
2 0 0 0 0 0 0 2 2 0 0 0 0 2 2 0 0 0 0 2 2 0 0 0 0 0 0 2 
2 0 2 2 2 2 2 2 2 2 2 2 0 2 2 0 2 2 2 2 2 2 2 2 2 2 0 2
2 1 2 2 2 2 2 2 2 2 2 2 0 2 2 0 2 2 2 2 2 2 2 2 2 2 1 2
2 0 0 0 0 0 0 0 0 0 0 0 0 0 0 0 0 0 0 0 0 0 0 0 0 0 0 2
2 2 2 2 2 2 2 2 2 2 2 2 2 2 2 2 2 2 2 2 2 2 2 2 2 2 2 2
